1111111111111111111111111111111111111111111111
111111100000000C000000000110011111100E00111111
1000001C00111111110001111100000000000000000001
10P000000C110000000011100000000000000000000001
10000011111000C0001110011000000000001111000001
11101110000C000011100000110000001100011C000001
10V000000011111110000000001100001111111000C001
100000000000000000C000000000000001111100000001
10000000000C000000000000C0000000011111000C00C1
10000C00000000000000000000V0000001111110C0C001
1100000000000001111100011100000000000000001111
1111111111111111111111111111111111111111111111